1111111111
1000000001
10P000E001
1000000001
1000100001
1001C10001

1000100001
1000000001
1000000001
1111111111