1111111111
1000000001
1011100001
100C1P0E01
1111110111
1000000001
1011100001
100C100E01
1000000001
1011100001
100C100E01
1000000001
1011100001
100C100E01
1000000001
1011100001
100C100E01
1000000001
1011100001
100C100E01
1000000001
1011100001
100C100E01
1000000001
1011100001
100C100E01
1000000001
1011100001
100C100E01
1111111111