1111111111111111111
1000000000000000001
100PE0000000C000001
1000000000P0000C001
1000000000000000001
1C00010000000000001
1000001000000000001
10000001000C0000001
1000000010000000001
10P00000C100000E001
1000000000000000001
1111111111111111111