1111111111111111111
10E0100000000000001
10P0100100000000001
1000100100000E00001
1000100100000000001
10001C0100000000001
1101111100011111111
10000000000000000C1
10000000000100000C1
1111111111111111111