111111111111111111
100000001000000001
100000001000000001
1000C00010000C0001
100000001000000001
1000E00010000E0001
100000001000000001
100000001000000001
100000000000000001
11111111P111111111
100000000000000001
100000001000000001
100000001000000001
1000E00010000E0001
100000001000000001
1000C00010000C0001
100000001000000001
100000001000000001
111111111111111111