1111111111
10P0000001
1011100001
100C100E01
1111111111
10P0000001
1011100001
100C100E01
10P0000001
1011100001
100C100E01
10P0000001
1011100001
100C100E01
10P0000001
1011100001
100C100E01
10P0000001
1011100001
100C100E01
10P0000001
1011100001
100C100E01
10P0000001
1011100001
100C100E01
10P0000001
1011100001
100C100E01
1111111111