1111111111111111111111111111111111111111111111111
1000100000001C00000000000000000000000000000000001
10E010P000000000000000000000000000000000000000001
1000100000001000010000000000000000000000000000001
10000000100C0000010000000000100000000000000000001
1111111111111111111111111111111111111111111111111